41 41 41 41 41 41 41 41 41 41 41 41 41 41 41 41 41 41 41 41 41 41 41 41 41
46 00 00 00 48 00 00 43 44 00 48 44 00 00 48 00 00 00 43 48 00 48 43 00 47
46 00 42 43 48 43 42 48 45 48 48 39 42 00 44 45 48 48 45 44 43 44 44 00 47
46 00 48 39 00 43 48 00 47 46 48 00 45 00 48 44 00 00 43 44 48 39 48 00 47
46 42 48 00 00 00 45 00 00 45 43 43 48 48 48 00 45 00 00 48 00 00 43 44 47
46 45 48 43 48 39 48 00 48 00 00 47 41 41 46 48 44 00 48 45 43 45 00 48 47
46 48 43 45 48 45 00 48 39 45 00 47 41 41 46 48 43 00 00 39 43 00 44 00 47
46 48 45 45 42 48 48 43 48 44 00 47 41 41 46 00 48 39 48 48 45 48 48 00 47
46 48 44 48 00 45 00 00 44 43 00 47 41 41 46 00 00 47 46 00 00 48 45 48 47
46 45 48 44 00 43 45 00 45 00 48 48 43 43 48 00 48 00 00 44 00 44 48 00 47
46 44 48 00 48 48 00 43 43 45 00 44 00 00 47 46 48 43 48 00 43 00 48 44 47
46 48 48 44 00 42 00 00 44 00 44 48 43 48 00 00 44 00 44 45 48 44 48 00 47
46 00 39 45 00 43 43 00 48 39 00 47 46 48 45 00 43 00 39 44 48 45 39 00 47
46 00 00 48 48 00 45 45 48 43 00 45 00 48 39 44 48 48 48 43 48 43 00 00 47
41 41 41 41 41 41 41 41 41 41 41 41 41 41 41 41 41 41 41 41 41 41 41 41 41


