56 56 56 56 56 56 56 56 56 56 56 56 56 56 56 56 56 56 56 56 56 56 56 56 56
56 00 00 00 01 01 01 01 01 00 00 00 00 01 01 00 00 01 01 00 00 00 00 00 56
56 00 56 00 56 00 56 00 56 01 56 00 56 00 56 00 56 01 56 00 56 00 56 01 56
56 00 00 00 00 00 00 00 00 01 01 00 00 00 00 00 00 00 00 00 00 00 00 01 56
56 00 56 00 56 00 56 00 56 00 56 00 56 00 56 00 56 00 56 00 56 00 56 00 56
56 00 00 00 00 00 01 01 00 00 00 00 01 01 01 01 01 01 01 01 01 00 01 01 56
56 00 56 01 56 00 56 01 56 00 56 00 56 00 56 00 56 00 56 00 56 01 56 00 56
56 00 00 01 00 00 00 00 01 01 01 00 00 00 00 00 00 00 00 00 00 00 00 00 56
56 00 56 01 56 00 56 00 56 00 56 01 56 00 56 00 56 00 56 01 56 00 56 01 56
56 00 01 00 01 00 00 00 01 00 01 00 00 00 00 00 00 00 00 01 00 00 01 01 56
56 01 56 00 56 01 56 00 56 01 56 00 56 00 56 00 56 01 56 00 56 01 56 00 56
56 01 00 00 00 00 00 00 01 00 00 00 00 00 00 01 01 01 01 01 01 00 00 00 56
56 00 56 01 56 01 56 01 56 01 56 01 56 00 56 01 56 00 56 01 56 00 56 00 56
56 00 00 01 01 01 01 01 01 01 00 01 00 00 01 00 00 00 00 01 00 00 01 00 56
56 56 56 56 56 56 56 56 56 56 56 56 56 56 56 56 56 56 56 56 56 56 56 56 56